0001110000000000000000-
1011010011100000000000-
1010010010000000000000-
1010011010000000000000-
1010001010000000000000-
1010001010000000000000-
1110001110000000000000-
0000000000000000000000-
0000000000000000000000-
0000000000000000000000-
0000000000000000000000-
0000000000000000000000